{
  "id": "boxfresh_interior_lab",
  "name": "Prof Sole's Lab",
  "width": 12,
  "height": 10,
  "collision": [
    1,1,1,1,1,1,1,1,1,1,1,1,
    1,0,0,0,0,0,0,0,0,0,0,1,
    1,0,0,0,0,0,0,0,0,0,0,1,
    1,0,0,0,0,0,0,0,0,0,0,1,
    1,0,0,0,0,0,0,0,0,0,0,1,
    1,0,0,0,0,0,0,0,0,0,0,1,
    1,0,0,0,0,0,0,0,0,0,0,1,
    1,0,0,0,0,0,0,0,0,0,0,1,
    1,0,0,0,0,0,0,0,0,0,0,1,
    1,1,1,1,1,3,1,1,1,1,1,1
  ],
  "ground": [
    0,0,0,0,0,0,0,0,0,0,0,0,
    0,0,0,0,0,0,0,0,0,0,0,0,
    0,0,0,0,0,0,0,0,0,0,0,0,
    0,0,0,0,0,0,0,0,0,0,0,0,
    0,0,0,0,0,0,0,0,0,0,0,0,
    0,0,0,0,0,0,0,0,0,0,0,0,
    0,0,0,0,0,0,0,0,0,0,0,0,
    0,0,0,0,0,0,0,0,0,0,0,0,
    0,0,0,0,0,0,0,0,0,0,0,0,
    0,0,0,0,0,0,0,0,0,0,0,0
  ],
  "overlay": [
    0,0,0,0,0,0,0,0,0,0,0,0,
    0,0,0,0,0,0,0,0,0,0,0,0,
    0,0,0,0,0,0,0,0,0,0,0,0,
    0,0,0,0,0,0,0,0,0,0,0,0,
    0,0,0,0,0,0,0,0,0,0,0,0,
    0,0,0,0,0,0,0,0,0,0,0,0,
    0,0,0,0,0,0,0,0,0,0,0,0,
    0,0,0,0,0,0,0,0,0,0,0,0,
    0,0,0,0,0,0,0,0,0,0,0,0,
    0,0,0,0,0,0,0,0,0,0,0,0
  ],
  "connections": {"north": null, "south": null, "east": null, "west": null},
  "wild_encounters": [],
  "npcs": [
    {"id": "npc_prof_sole", "x": 6, "y": 3, "facing": "down", "sprite": "npc_prof_sole", "movement": {"type": "Stationary"}, "dialogue_id": "prof_sole_intro", "is_trainer": false, "sight_range": 0, "trainer_id": 0}
  ],
  "events": [
    {"id": "ev_lab_exit", "x": 5, "y": 9, "event_type": "warp_trigger", "data": "boxfresh_town:23:7"}
  ],
  "music": "boxfresh_town_bgm"
}
